XsXXXXXXXXXXXXXXXXXXXXXXX
X+++++X       X         X
XXXXX+X XXXXX X XXXXXXX X
X+++++X     X   X       X
X+XXXXXXXXXXXXX XXXXXXXXX
X+++X           X+++++X X
XXX+X XXXXXXXXXXX+XXX+X X
X X+X     X     X+X+++  X
X X+XXX XXX XXX X+X+XXX X
X X+++X     X   X+X+++X X
X XXX+XXXXXXX XXX+XXX+X X
X X+++  X+++++++++X+++X X
X X+XXXXX+XXXXXXXXX+XXXXX
X X+++X+++X   X   X+X   X
X X X+X+XXXXX X X X+X X X
X   X+X+  X   X X X+X X X
X XXX+X+X X XXX X X+XXX X
X   X+++X   X   X  +++++X
XXXXXXXXXXXXXXXXXXXXXXXgX
