15 7
XsXXXXXXXXXXXXX
X X        X  X
X  XXXXX X XXXX
X XXX  X X X  g
X   X XX X X XX
XXX      X    X
XXXXXXXXXXXXXXX
