10 10
XsXXXXXXXX
X XX XXX X
X    XX  X
XXXX    XX
X XX X XXX
X    XXX X
X XXXX   X
X      X X
XX XX XX X
XXXXXXXXgX
